111111111111111
1S0000000000001
101111111111001
1010001D0001001
101011111101001
100000000000001
111111111111111