111111111111111111111111111111
1S000000000000000000000000KKK1
111111111L11111000111111L11111
100000000L00000000000000L00001
11L1111111111000111L1111111111
10L0000000000000000L0000000001
11111111111111L111110111L11111
10000000000000L000000000L000D1
111111111111111111111111111111