111111111111111
1S0100000000001
100100111000101
101001111100001
1010111D1110101
101001101100101
101000101000101
100000100000001
111111111111111
