111111111111111
1S0000000000001
111111111111001
100000000000001
101011111111111
1000000000000D1
111111111111111